211001101110000102110
000100301012300100010
110000001030110000301
020110012200010210111
310000300010010031001
131001101113310000010
300110000310000100110
000020331021300010001
111120000100000102000
031100000101000100303
000322031343001000001
111010001000030010000
300000003023101001233
030110301000120030300
100200000001301100000
103000033201001000111
013200000000100010130
130001000010010010101
300000300013030301020
001120103031111001300
303010000000330013001
