110130011310013000003
031001223201000000121
013100010300021100010
203321011100100000030
210110100110101001111
000201000011000010000
000100200100102110000
001112110000010300011
111030013031001010000
211311010000010000102
013001003340330100000
000130000100023000031
001300310000130000010
100100130000311001200
000100200020000031311
000033000112030100210
113010210000100300011
110300033310131011300
110000100010003130100
230020113130111210320
032001003110000311333
