020003011013001001301
101100003000300100220
310000201000001000111
100032032010110011101
001310001001010001211
003000300213010200131
132001103103100030001
003203333010003010011
030200032100000200000
001001000210103000000
031000031142300211130
001110111021013010103
020000313310000103030
130001100000000003031
001000000330133010000
001032000010120000030
301300300103033011103
013000111000001101100
311010201000000002010
000110230221001000000
100100200011000000100
